###############################
#S------#---------#-----#-----#
#-###############-#-#-#-#-#-#-#
#-#-----#-------#---#-#-#-#-#-#
#-#-#-#-#####-###-#####-###-###
#---#-#-#-#-#-------#---#-----#
#-#-#####-#-###-#####-###-#####
#-#-------#-#---#-#-#-#-------#
###-#######-###-#-#-#-#-###-#-#
#-#-----#---------#-#-#---#-#-#
#-###-###-#######-#-#-###-###-#
#-#-----#-#-#-#-----#-----#---#
#-#-###-#-#-#-#######-#-#####-#
#-----#-------#---#---#-----#-#
#-###-###-#-###-###-#-###-#-###
#-#---#-#-#---#-#---#---#-#---#
#-#-###-###-###-#####-###-#-###
#-#-----#-----------#-#-#-#---#
#-#-#########-###-#####-#####-#
#-#-#-#-#-#---#-------#-------#
###-#-#-#-###########-#-#######
#-----------#---#---#-#-------#
#######-###-#-#####-#-#-#-#-#-#
#-#---#-#-#-#-#---#-#-#-#-#-#-#
#-###-#-#-###-###-#-###-###-###
#-----#---#-----#-#-#---#---#-#
#-###-#-#-#-#####-#-#-###-###-#
#-#---#-#-----#-----#-#-#---#-#
#-###-#-#-#####-###-###-###-#-#
#-#-----#-#-------#-----------E
###############################
