###############################
#S--#-----#---#-------#-------#
#-#####-#####-#######-###-#####
#-------------#-----------#---#
#-#-###-###-#####-#####-#-#-###
#-#---#-#-#---------#-#-#---#-#
#-#####-#-#-###-#-###-#-#####-#
#-#-#---#-----#-#-#-----#---#-#
#-#-#####-#######-#########-#-#
#-------#---#-#---#-----#-----#
###-#-#####-#-#########-###-###
#-#-#-#-#-#-#-------#-#-#-#-#-#
#-#-###-#-#####-#-###-#-#-#-#-#
#---#-#-#-------#-#-----#-----#
###-#-#-#-###-###-#-#-###-#-#-#
#-#---#-----#-#-#---#-#---#-#-#
#-#-#######-#-#-###-#########-#
#---#---#---#-----#---#-----#-#
#-###-#####-###-###-#-###-###-#
#-----#-#---#---#-#-#-#-------#
#-###-#-###-#####-#-###-#######
#-#-----------#---#-----#-#---#
#####-#####-#####-#####-#-#-#-#
#-------#---#-#-------------#-#
#####-#######-#-###-#####-#-###
#-------------#---#-----#-#---#
#-###########-#-#-###-#######-#
#---------#-#-#-#-#---#---#---#
#-#######-#-#-#-###-#-###-#-###
#-#---------#-#-#---#---#-----E
###############################
