###############################
#S----#---#---------#-----#-#-#
#-#-#-#-#-#####-#-#-#-#-###-#-#
#-#-#---#---#-#-#-#---#---#---#
#####-#-#-###-#-###-#######-###
#---#-#-#-#-----#---#---------#
###-#####-#-#####-#-###-###-###
#---#-#-#-----#-#-#-----#---#-#
###-#-#-#-#-###-#####-#######-#
#---#-----#-------#-----#-----#
#-###-#####-#-#-###-###-###-###
#---#---#-#-#-#-#---#-------#-#
#-#######-#-###-#-#-#####-#-#-#
#---#-#-#---#---#-#-----#-#---#
#-#-#-#-#-#####-###-###-#-#####
#-#-#-----#---#-#---#-#-#-#---#
###-#-#-###-###-###-#-#-#-#-###
#-#-#-#-------#---#---#-#---#-#
#-#-#-#-###-#-#######-###-#-#-#
#---#-#-#---#-----#-#-#-#-#---#
#-#######-#-#######-###-#-#-###
#-#---#---#-----#-#---#---#---#
#-#-#####-#######-#-#-#-###-###
#---#---#---------#-#---#-----#
#-###-#####-#########-#########
#-#-#-----------#-------#-----#
#-#-#-#####-###-#-#-###-#-###-#
#---#---#---#-#-#-#---#-----#-#
#-#-###-#####-#-#-#-#-#####-###
#-#-----------#-#-#-#-----#---E
###############################
