#################################################################################
#S------#-#-----#-#---#-#---------#-#---#-------#---#-------#-------------------#
#####-#-#-#-###-#-#-###-#########-#-###-#-#-###-#-#####-###-#####-###-###-###-###
#-----#-#-----#-#---#-----------#-#-------#-#-#-----#-----#-#-----#---#---#-----#
#####-###-#-#-###-###-###-#####-#-#-#-###-###-#-###-#-#########-#-###-#-#-###-###
#-#-----#-#-#---#-----#---#-------#-#-#---#-#-#-#-#---#-#-------#---#-#-#---#---#
#-#####-#####-###-#-#########-#####-#-#####-#-#-#-#####-###-#####-#-###-#-#-#-###
#-#---#-#-------#-#-#---#-----#-#---#---#-------#-#---#-#-#-#---#-#-#-#-#-#-#---#
#-#-###-#-#-#####-#-#-#-#-#-###-###########-#-###-#-#-#-#-#-#-#####-#-#-#####-###
#-#---#---#---#---#-#-#-#-#-#-#-----#---#---#-#---#-#-#-------#-------#-#-----#-#
#-###-#-#-#######-#####-###-#-#####-###-#-#-#-#-###-###-#-#-###-#-###-#######-#-#
#---#-#-#-#---#-#-#-#---#-#---#-#-#-#---#-#-#-----#-#---#-#-#-#-#-#---#---------#
###-#-###-#-#-#-###-###-#-#-###-#-#-###-#-#####-###-#########-#-#-#########-#-###
#-----------#---#-#-----#-#---#-#---------#---#---#-#-#---#-----#-#---#---#-#---#
###-#####-#-#-###-#####-#-###-#-#######-###-#####-#-#-###-#-#-#######-###-###-###
#-------#-#-#---#-------#---#-------#---#-#-------------#---#-#-#-----#---------#
#####-###-#####-#-###-###-#######-#-#-###-#######-###-###-#-#-#-#####-#-#-###-#-#
#---#---#-#---------#-#-#---#-#---#-----#---#-----#-------#-#---#-#-#-#-#---#-#-#
#-#-#-#########-#-#-#-#-#-###-#####-###-###-#-###-#####-#-#####-#-#-#-#####-###-#
#-#-#---#-#-----#-#-#---------#---#---#-----#-#-#-----#-#---#-#---#-----#-#-#-#-#
###-###-#-#-#########-###-###-#-###-#-#-###-#-#-#######-###-#-#-#######-#-###-###
#---#-#-#-#-#---------#-#---#---#-#-#-#---#-#---#---#---#-#---#-#-----#-#-------#
#-###-###-###-#########-#-#-#-###-#-#####-#######-#####-#-###-###-###-#-#-#######
#---#---#-----#-#-------#-#-#-------#-#-------#-----#---#-#---#-----#-#---#-#-#-#
#-#-###-#####-#-#-###-#####-#########-#-###########-#-###-#-###-#-###-#-###-#-#-#
#-#---#-----#-------#-#---#---#-#---#---------#-#-#-------#-#-#-#-#-----#---#---#
#####-#####-#-#-###-#####-#-#-#-#-#-###-#######-#-#-###-#####-#######-#-#-###-###
#---#-------#-#-#---#-------#-#-#-#-#-----------#---#---#-#-#-#-----#-#-#---#---#
#-#-###-###-###-#-#-#####-###-#-#-###-#######-#-#-#####-#-#-#-#-###-#-###-#####-#
#-#-------#-#-#-#-#---#---#-------#---------#-#-#-#-#---#-----#-#-#-#-------#---#
#####-###-#-#-#-#-###-#####-#####-#-#####-#-#####-#-#-###-#-#-#-#-###-#####-###-#
#-#---#---#-#---#-#-#-#-#-#---#-#-#---#---#-#-----#-----#-#-#---#---#-#---#-----#
#-#-###-###-#-#-###-#-#-#-###-#-#-#-###-#############-#######-#####-#-###-###-###
#-#-#---#-----#-#-----#---#-----#-#-#-#-#-------#---#---#-------#-----------#-#-#
#-###-#-###-###-###-###-#######-#####-###-#-###-#-#####-#######-###-#-#-###-###-#
#-#---#-#---#---#-#---#---#-----------#---#---#-#-#---#---#---------#-#-#-----#-#
#-#-###-#####-###-#-###-#####-#-###-#######-###-#-#-#-#-###########-#########-#-#
#---#-#-#-----#-------------#-#---#-#-#-#-----#-#-#-#-#---------#-#---#---#---#-#
#-###-#-#-#######-#####-#######-#-###-#-#-#####-#-#-#####-#####-#-#-#-###-#####-#
#---#-#-#-#-#-----#---------#---#-#-----#-#-#---#---#---------#-#-#-#-------#---#
#-###-#####-#-###############-###-#-#######-#-#-#-###-###-#-#####-###-#-###-#-###
#---#-----#-------------#-#-#-#---#-#-#-----#-#-#-#-#---#-#-#-----#---#---#-----#
#####-#-#####-#-###-#####-#-###-#-#-#-#####-###-#-#-#######-###-#######-###-###-#
#---#-#-----#-#-#-----------#-#-#-----#---------#-#-#---------#-------#---#---#-#
#-###-#####-###-###-#-###-###-#-###############-#-#-#-#####-#-#-#####-#-#####-#-#
#-----#-------#-#---#---#-#-#---#-----#-#-#-#-----#-#-#-----#---#-#-#---#-----#-#
#-###-###-#-#####-#-#-#-###-#####-#####-#-#-#-#####-###-#-#####-#-#-###########-#
#-#-----#-#---#---#-#-#-----#-------#-#-#-#---#-#---#---#---#---#-----#-------#-#
#######-###-#-#-###-###########-#####-#-#-###-#-#-#-#-###-#####-#####-#-#-#-#-###
#-----#---#-#---#-----#-----#---#---------#-#-#---#---#-#-#-----#-------#-#-#---#
#####-###-###-###-###-#-#######-###-#-#####-#-#####-#-#-#-###-#-###-###-###-#####
#-#---#---#-#---#---#-------#-----#-#---------#---#-#-#-----#-#-#-#-#-#---#-----#
#-#-###-###-#####-#######-###-#-#-#-#-#######-###-#-###-#########-#-#-###-#####-#
#---#-----#-#---#-------#---#-#-#-#-#-#-------------#---#---------#-#-#---#---#-#
#-###-#-###-#-#-###-#######-###-#-#########-###-#-#######-###-#-###-#-###-#-###-#
#---#-#-#-----#-#-#-----#---#-#-#-#---#-#-----#-#-----#-----#-#---#---#-#-----#-#
###-###-#####-###-#-#########-###-#-###-#-###-#########-###-#####-###-#-#-#-#####
#-----#-#-----#---#---------------#---------#-#-#---#-#---#-#-#-------#-#-#-----#
#-#-###-###-#-#-#-#-#-#-###-#####-#-###-###-#-#-#-###-#-#####-###-###-#-#########
#-#-#-----#-#---#---#-#---#-#---#-#-#-----#-#-------#---#---#-------#-----------#
#-#-###-#######-#-#####-#-#-###-#-#-#####-#-#-#-#-#-###-###-###-###########-###-#
#-#---#---#-#---#---#-#-#-#---#---#---#---#-#-#-#-#---#---#-----#---#-----#-#---#
#-#-#######-###-#-###-#######-###-#-#-#-###-#####-#-#########-#####-#-#-#-#######
#-#-----#-#-#-#-#-#---------#---#-#-#-#-#-------#-#-#-#-------------#-#-#-------#
#-###-###-#-#-#########-#-#########-#-###########-###-#-#-###-#####-#-###########
#-#-----#-----#-#-#-#-#-#---#-#---#-#---------#-#---#---#-#-#-----#-#---------#-#
###-#######-###-#-#-#-#-#-###-###-###-###-#####-###-#####-#-#-###-#######-#####-#
#---#-#---#-#-----------#---------#---#---#-#---#-#-#---#-#-#---#---#-------#---#
###-#-###-#-#-#####-###-###-#-###-#-#-#####-###-#-#####-###-###-#-#-#####-#-#-###
#-----------#---#-----#---#-#-#-----#---#-----#---#---#---#-#-#-#-#-#-----#-#---#
#-#-###-#-#-#-###-#-#-###-###-#########-#-#-#####-#-#-#-###-#-###-#-#-#-###-#-###
#-#---#-#-#---#---#-#---#---#---#---#-----#---#-#---#---#---#-#---#-#-#---#-#-#-#
#########-#-#-#########-#####-#####-#-#-###-###-#-###-###-#-#-#-###-#-#####-#-#-#
#---------#-#-#---#---#-----#-#-#-----#-#---------#---#---#-#---#-------#-#-----#
#-#-###-#-#####-#-#-###-#-###-#-#-###-###-#-#-###-###-#-###-#-#####-#-#-#-#-#-#-#
#-#---#-#---#-#-#-----#-#---#---#-#-#-#---#-#---#-#-#---#-#---#-----#-#-#---#-#-#
#-#######-###-#-#-#-#-###-#####-#-#-###-#####-#####-#####-#-#-###-#########-###-#
#-#-#-------#-#-#-#-#-----#---#-#-----#-----#---------#-----#-#-----#---------#-#
#-#-###-#-###-#-#####-#-###-#-###-#-#-#-#-#-#-#####-#####-#######-#-#-#######-###
#---#---#-----#-#-----#-----#---#-#-#-#-#-#-#---#-----#-------#---#-#-------#---E
#################################################################################
